2
200 200
500 500
15 15
@@@@@@@@@@@@@@@
@0000000000000@
@0000000000000@
@0000000000000@
@0000000000000@
@0000000000000@
@0000000000000@
@0000000000000@
@0000000000000@
@0000000000000@
@0000000000000@
@0000000000000@
@0000000000000@
@0000000000000@
@@@@@@@@@@@@@@@