2
200 200
400 400
15 15
@@@@@@@@@@@@@@@
@0000000000000@
@0000000000000@
@0000000001100@
@0000000000000@
@0000000000000@
@0100000000000@
@0000000000000@
@0000001000000@
@0100000000000@
@0000000000000@
@0000010000000@
@0110000000000@
@0110000000000@
@@@@@@@@@@@@@@@