1
200 200
15 15
@@@@@@@@@@@@@@@
@0000000000000@
@0000000000000@
@0000000000000@
@0000000000000@
@0000000000000@
@0000000000000@
@0000000000000@
@0000000000000@
@0000000000000@
@0000000000000@
@0000000000000@
@0000000000000@
@0000000000000@
@@@@@@@@@@@@@@@